101010101010101
101111111111101
100000010001001
101111010101101
101001010100001
101101111101101
100000010001001
111111111111111
100000010001001
101101111101101
101001010100001
101111010101101
100000010001001
101111111111101
101010101010101
