1110000000000111000000000000011111111111111111111111111111111111111111
1110000000001111100000000000011111111111111111110000000000000000000000
1110000000011111000000000000011100000000111111111000000000000000000000
1110000000011110000000000000011100000000000011111000000000000000000000
1110000000111100000000000000011100000000000001111100000000000000000000
1110000001111000000000000000011100000000000000111100000000000000000000
1110000011111000000000000000011100000000000000011100000000000000000000
1110000111110000000000000000011100000000000000011100000000000000000000
1110001111000000000000000000011100000000000000111000000000000000000000
1110011111000000000000000000011100000000000000111000000000000000000000
1110111110000000000000000000011100000000000001111000000000000000000000
1111111100000000000000000000011100000000000001110000000000000000000000
1111111000000000000000000000011100000000000011110000000000000000000000
1111110000000000000000000000011100000000000111100000000000000000000000
1111100000000000000000000000011100000000011111000000000000000000000000
1111000000000000000000000000011100000000111110000000000000000000000000
1111000000000000000000000000011100000011111110000000000000000000000000
1111100000000000000000000000011111111111111100000000000000000000000000
1111100000000000000000000000011111111111110000000000000000000000000000
1111110000000000000000000000011111111000000000000000000000000000000000
1111110000000000000000000000011111000000000000000000000000000000000000
1111111000000000000000000000011111100000000000000000000000000000000000
1111111000000000000000000000011111110000000000000000000000000000000000
1111111100000000000000000000011111111000000000000000000000000000000000
1110111100000000000000000000011111111100000000000000000000000000000000
1110111110000000000000000000011101111110000000000000000000000000000000
1110011110000000000000000000011100111111000000000000000000000000000000
1110011111000000000000000000011100011111000000000000000000000000000000
1110001111000000000000000000011100001111100000000000000000000000000000
1110001111100000000000000000011100000111110000000000000000000000000000
1110000111110000000000000000011100000011111000000000000000000000000000
1110000111110000000000000000011100000001111100000000000000000000000000
1110000011111000000000000000011100000001111110000000000000000000000000
1110000001111100000000000000011100000000011111000000000000000000000000
1110000001111100000000000000011100000000001111100000000000000000000000
1110000000111110000000111110011100000000000111111000000000000000000000
1110000000011110000000111110011100000000000011111100000000000000000000
1110000000001111000000111110011100000000000000111110000000000000000000
1110000000000111000000111110011100000000000000011111100000000000000000
1110000000000111111111111111111100000000000000001111110000000000000000
