1110000000000111000000000000011111111111111111110000000000000000000001
1010000000001101100000000000011111111111111111110000000000000000000001
1010000000011001000000000000011100000000111111111000000000000000000001
1010000000110011000000000000011100000000000011111000000000000000000001
1010000001100110000000000000011100000000000001111100000000000000000001
1010000011001100000000000000011100000000000000111100000000000000000001
1010000010011100000000000000011100000000000000011100000000000000000001
1010000110111000000000000000011100000000000000011100000000000000000001
1010001100100000000000000000011100000000000000111000000000000000000001
1010111001100000000000000000011100000000000000111000000000000000000001
1011100111000000000000000000011100000000000001111000000000000000000001
1011001100000000000000000000011100000000000001110000000000000000000001
1010011000000000000000000000011100000000000011110000000000000000000001
1000110000000000000000000000011100000000000111100000000000000000000001
1011100000000000000000000000011100000000011111000000000000000000000001
1011000000000000000000000000011100000000111110000000000000000000000001
1010000000000000000000000000011100000011111110000000000000000000000001
1010100000000000000000000000011101111111111100000000000000000000000001
1010100000000000000000000000011101111111110000000000000000000000000001
1010110000000000000000000000011101111000000000000000000000000000000001
1010110000000000000000000000011101000000000000000000000000000000000001
1010111000000000000000000000011101100000000000000000000000000000000001
1010111000000000000000000000011101110000000000000000000000000000000001
1010111100000000000000000000011101111000000000000000000000000000000001
1010111100000000000000000000011101111100000000000000000000000000000001
1010111110000000000000000000011101111110000000000000000000000000000001
1010111110000000000000000000011100111111000000000000000000000000000001
1010111111000000000000000000011100011111000000000000000000000000000001
1010101111000000000000000000011100001111100000000000000000000000000001
1010101111100000000000000000011100000111110000000000000000000000000001
1010100111110000000000000000011100000011111000000000000000000000000001
1010100111110000000000000000011100000001111100000000000000000000000001
1010100011111000000000000000011100000001111110000000000000000000000001
1010100001111100000000000000011100000000011111000000000000000000000001
1010100001111100000000000000011100000000001111100000000000000000000001
1010100000111110000000111110011100000000000111111000000000000000000001
1010100000011110000000111110011100000000000011111100000000000000000001
1010100000001111000000111110011100000000000000111110000000000000000001
1010100000000111000000111110011100000000000000011111100000000000000001
1011100000000111111111111111111100000000000000001111111111111111111111
