1111111111111011111111111101111111111111111111011111111111111111101
1000000000001010100001000111010100000000000000010010000000000000001
1011111111111010111100010100000111111111111111110111111111111111101
1000100000000010000101111101010000000000000000000000000000000001001
1011101101111111110100000111111111111111111111111111101010101101101
1000001001000000000111110000000000000000000000000010001111101000101
1111111101111110000000000111111111111111101111111111101000111000101
0000000100000011111111110100000000000000101010100000001110100000101
1111110111111110000000000111111111111110101000101111111010111110101
1000000100000010011111000000000000000010100011101010000010100010001
1011110101111011110001011111101111111110101000101010111010101110101
1000010101000000000100010000000000101010111111101010101010101000101
1111010111111111111111111111111110101010000000001010101010101011101
1000010001000000000000000000000010101011111111111010001010100010101
1011111111011101111111111111111010101010101010100011011010111010101
1000000000010101000000000000001010101000000000001001010010101000101
1111111111110101111111111111101010101111111101111111010110101110101
0000000000000100000001010000001010101000000000000000010000100010101
0111111111111111111100000000001010101010011111111111111111101110101
0101000000000000000100111111111010101011010000000000010000000000101
0100011111111111110100100000000010101010010111111111110111111110101
1111110000000000010111101111111010101010110000000000010000000010101
0000010001101111010100001000010010101010011111111111011111111110101
1111011101001001010100011111011010101011010000000000010000000000101
0100000101001001010111000001010010101110010111111111111111111111101
0101110101001001010100001111011010100000010000000000000000000000001
1100010101001001010101000000010010111111011111111111111111111111111
0111110101111001010111111111111010100001000000000000000000000000001
0100000100001001010100000000000010111101111111101111111111111111111
1111111101111011010100010010010110100100000000000000000000000000000
0000000100001010010111111111110010100111111111111111111111111111111
1111111101111011010100010001010110100000000000000001010000000000000
1000000001001001010101000100010010111111101111110101001111011111111
1111111111101011010101111111110110100000001000011101101010001000000
0000000000001010010000000000000010111111111111000000001000101011111
1111111111111011011111111111111110000000000001111111111111111110000
